{
    "testMap": {
        "width": 3,
        "tiles":[
            [[18, 5, 0, 0, 0, 0, 6, 0, 0, 50],
            [52, 5, 0, 0, 0, 0, 6, 0, 0, 50],
            [52, 0, 6, 0, 0, 5, 0, 0, 5, 50],
            [52, 0, 0, 0, 0, 0, 0, 0, 6, 50],
            [52, 6, 0, 5, 0, 6, 0, 0, 0, 50],
            [52, 0, 6, 0, 5, 0, 6, 0, 0, 50],
            [52, 0, 5, 0, 6, 0, 5, 6, 0, 50],
            [52, 0, 0, 5, 0, 0, 0, 0, 5, 50],
            [52, 0, 0, 0, 6, 0, 0, 6, 0, 50],
            [146, 19, 19, 19, 19, 19, 19, 19, 19, 147]],
            [[18, 5, 0, 0, 0, 0, 6, 0, 0, 50],
            [52, 5, 0, 0, 0, 0, 6, 0, 0, 50],
            [52, 0, 6, 0, 0, 5, 0, 0, 5, 50],
            [52, 0, 0, 0, 0, 0, 0, 0, 6, 50],
            [52, 6, 0, 5, 0, 6, 0, 0, 0, 50],
            [52, 0, 6, 0, 5, 0, 6, 0, 0, 50],
            [52, 0, 5, 0, 6, 0, 5, 6, 0, 50],
            [52, 0, 0, 5, 0, 0, 0, 0, 5, 50],
            [52, 0, 0, 0, 6, 0, 0, 6, 0, 50],
            [146, 19, 19, 19, 19, 19, 19, 19, 19, 147]],
            [[18, 5, 0, 0, 0, 0, 6, 0, 0, 50],
            [52, 5, 0, 0, 0, 0, 6, 0, 0, 50],
            [52, 0, 6, 0, 0, 5, 0, 0, 5, 50],
            [52, 0, 0, 0, 0, 0, 0, 0, 6, 50],
            [52, 6, 0, 5, 0, 6, 0, 0, 0, 50],
            [52, 0, 6, 0, 5, 0, 6, 0, 0, 50],
            [52, 0, 5, 0, 6, 0, 5, 6, 0, 50],
            [52, 0, 0, 5, 0, 0, 0, 0, 5, 50],
            [52, 0, 0, 0, 6, 0, 0, 6, 0, 50],
            [146, 19, 19, 19, 19, 19, 19, 19, 19, 147]],
            [[18, 5, 0, 0, 0, 0, 6, 0, 0, 50],
            [52, 5, 0, 0, 0, 0, 6, 0, 0, 50],
            [52, 0, 6, 0, 0, 5, 0, 0, 5, 50],
            [52, 0, 0, 0, 0, 0, 0, 0, 6, 50],
            [52, 6, 0, 5, 0, 6, 0, 0, 0, 50],
            [52, 0, 6, 0, 5, 0, 6, 0, 0, 50],
            [52, 0, 5, 0, 6, 0, 5, 6, 0, 50],
            [52, 0, 0, 5, 0, 0, 0, 0, 5, 50],
            [52, 0, 0, 0, 6, 0, 0, 6, 0, 50],
            [146, 19, 19, 19, 19, 19, 19, 19, 19, 147]],
            [[18, 5, 0, 0, 0, 0, 6, 0, 0, 50],
            [52, 5, 0, 0, 0, 0, 6, 0, 0, 50],
            [52, 0, 6, 0, 0, 5, 0, 0, 5, 50],
            [52, 0, 0, 0, 0, 0, 0, 0, 6, 50],
            [52, 6, 0, 5, 0, 6, 0, 0, 0, 50],
            [52, 0, 6, 0, 5, 0, 6, 0, 0, 50],
            [52, 0, 5, 0, 6, 0, 5, 6, 0, 50],
            [52, 0, 0, 5, 0, 0, 0, 0, 5, 50],
            [52, 0, 0, 0, 6, 0, 0, 6, 0, 50],
            [146, 19, 19, 19, 19, 19, 19, 19, 19, 147]],
            [[18, 5, 0, 0, 0, 0, 6, 0, 0, 50],
            [52, 5, 0, 0, 0, 0, 6, 0, 0, 50],
            [52, 0, 6, 0, 0, 5, 0, 0, 5, 50],
            [52, 0, 0, 0, 0, 0, 0, 0, 6, 50],
            [52, 6, 0, 5, 0, 6, 0, 0, 0, 50],
            [52, 0, 6, 0, 5, 0, 6, 0, 0, 50],
            [52, 0, 5, 0, 6, 0, 5, 6, 0, 50],
            [52, 0, 0, 5, 0, 0, 0, 0, 5, 50],
            [52, 0, 0, 0, 6, 0, 0, 6, 0, 50],
            [146, 19, 19, 19, 19, 19, 19, 19, 19, 147]]
        ],
        "objects":[
            {"obj": "chest", "coord": {"x": 5, "y": 5}},
            {"obj": "key", "coord": {"x": 5, "y": 7}}
        ]
    }
}